███████╗████████╗      ███╗   ███╗ █████╗ ██████╗ 
██╔════╝╚══██╔══╝██╗██╗████╗ ████║██╔══██╗██╔══██╗
█████╗     ██║   ╚═╝╚═╝██╔████╔██║███████║██████╔╝
██╔══╝     ██║   ██╗██╗██║╚██╔╝██║██╔══██║██╔═══╝ 
██║        ██║   ╚═╝╚═╝██║ ╚═╝ ██║██║  ██║██║     
╚═╝        ╚═╝         ╚═╝     ╚═╝╚═╝  ╚═╝╚═╝     
                                                  