R 1080 720
NO images/blue_wall.xpm
SO images/blue_wall.xpm
WE images/blue_wall.xpm
EA images/blue_wall.xpm
S images/tree.xpm
F 220,100,5
C 52, 73, 94

111111111111111111111111111111111111111
120002000200020002000200020002000200021
100200020002000200020002000200020002001
120002000200020002000200020002000200021
100200020002000200020002000200020002001
120002000200020002000200020002000200021
100200020002000200020002000200020002001
120002000200020002000200020002000200021
100200020002000200020002000200020002001
120002000200020002000200020002000200021
100200020002000200020002000200020002001
120002000200020002000200020002000200021
100200020002000200020002000200020002001
120002000200020002000200020002000200021
100200020002000200020002000200020002001
1200020002000200020N0200020002000200021
111111111111111111111111111111111111111