R 1080 720
NO images/shrek.xpm
SO images/square.xpm
WE images/mlp.xpm
EA images/haie.xpm
S ./path_to_the_sprite_texture
F 220,100,5
C 52, 73, 94

           111111
          11000011
       1111000000111
     1110000000000011
    110001111111000011
   1100011     11000011
  1100011       11000011
 1100001         11000011
 1000011111       11000011
 110002222111      1000011
  11211110001      11000011
   111  10S01       1100001
        1000111    11000011
        11000011  11000011
         1100001111000011
          11000000000011
           110000000111
            111111111