R 1080 	720
NO       	   ./images/purplestone.xpm
SO      ./images/mossy.xpm
WE             ./images/bluestone.xpm


EA       ./images/redbrick.xpm
S ./images/tree.xpm
F 84,  	84,	84
C 215, 219, 120

        111111111111111111111111
        1000000000110000000000001
        1011000M011100010ab000001
        1001000000000000020000001
111111111011000001110000000000001
100000000011000001110111121111111
1111c111111111011100000010001      1111
1111c111111111011101010000M01      1001
11000000110101011100000010001      1111
10000000cc0000001100000010001
10000000cc0000001101010010001
1100000111010101111101111000111
11110111 1110101 101111010N01
111 1111 1111111 111111111111