R 1920 1080
NO ./path_to_the_north_texture
SO ./path_to_the_south_texture
               WE ./path_to_the_west_texture
EA ./path_to_the_east_texture
S ./path_to_the_sprite_texture
F 220,100,5
C 225,30,0

111111111111111          11111
100000000000001          10001
100000000000001111111111110001111111
100000000000000000000000000000000001
100000000000000000000000000000000001
100000000000000000000000000000000001
100000000000000000000000000000000001
1000000000000000000000000000000000011111
1000000000000000000000000000000000000001
1000000000000000000000000000000000000001
1000000000000000000000000000000000010001
1000000000000000000000000000000000010001
1111111111111111111111111111111111111111