R 1920 1080
NO 225,30,0
SO 225,30,0
WE 225,30,0
EA 225,30,0

S ./path_to_the_sprite_texture
F 220,100,0
C 225,30,0

11111111111111111111111111
10000000000000000000000001
10000000000000000000000001
10000000000000000000000001
10000000000000000000000001
10000000000000000000000001
10000000000000000000000001
10000000000000000000000001
10000000000000000000000001
10000000000000000000000001
10000000000000000000000001
10000000000000000000000001
10000000000000000000000001
11111111111111111111111111