R 1080 720
NO ./images/greystone.xpm
SO ./images/greystone.xpm
WE ./images/greystone.xpm
EA           ./images/greystone.xpm
S ./images/barrel.xpm
F 84,84,84
C 127, 179, 213

        111111111111111111111111
        1000000000110000000000001
        1011000001110000000000001
        1001000200000000000000001
111111111011000001110000000000001
100000000011000001110111121111111
11110111111111011100000010001
11110111111111011101010000001
11000000110101011100000010001
10000000000000001100000010001
10000000000000001101010010001
11000001110101011111011110N0111
11110111 1110101 101111010001
11111111 1111111 111111111111