R 1080 720
NO images/shrek.xpm
SO images/square.xpm
WE images/mlp.xpm
EA images/haie.xpm
S ./path_to_the_sprite_texture
F 220,100,5
C 225,30,0

111111
1N0001
100001
100001
100001
111111