R 1080 720
NO                      ./images/purplestone.xpm
SO      ./images/mossy.xpm
WE              ./images/bluestone.xpm



EA       ./images/redbrick.xpm
S ./images/tree.xpm
F 84,84,84
C 215, 219, 4

111111
1N0001
100001
100001
100001
111111