R 1080 720

NO ./images/purplestone.xpm
SO ./images/mossy.xpm
WE ./images/bluestone.xpm
EA ./images/redbrick.xpm
S  ./images/ghost.xpm

F 46,   62, 83
C 0,15,137

11111111111111111111
100000000S0000000001
10000000000000000001
10000000000000000001
10000000000000000001
10000000000000000001
10000000000000000001
100000000M0000000001
10000000000000000001
10000000000000000001
11111111111111111111