R 1080 720
NO images/shrek.xpm
SO images/square.xpm
WE images/mlp.xpm
EA images/haie.xpm
S ./path_to_the_sprite_texture
F 220,100,5
C 225,30,0

11111111111111111111
10000000000000000001
10000000000000000001
10000000000000000001
10000000000000000001
100000000N0000000001
10000000000000000001
10000000000000000001
10000000000000000001
10000000000000000001
11111111111111111111