R 1080 720
NO images/blue_wall.xpm
SO images/blue_wall.xpm
WE images/red_wall.xpm
EA images/red_wall.xpm
S images/ghost.xpm
F 174, 214, 241
C 215, 219, 221

11111111111111111111
10000000000000000001
12222222222222222221
12222222222222222221
12222222222222222221
12222222222222222221
10000000000000020001
10000200000000000001
10000000000000000001
100000000N0000000001
11111111111111111111