R 1080 720
NO images/blue_wall.xpm
SO images/blue_wall.xpm
WE images/red_wall.xpm
EA images/red_wall.xpm
S images/tree.xpm
F 174, 214, 241
C 215, 219, 221

11111111111111111111
10000000000000000001
10000000000000000001
10000000000000000001
10000000000000000001
10000000020000000001
10000000000000000001
10000000000000000001
10000000000000000001
100000000N0000000001
11111111111111111111