R 1080 720
NO ./images/purplestone.xpm
SO ./images/mossy.xpm
WE ./images/bluestone.xpm
EA ./images/redbrick.xpm
S  ./images/tree.xpm
F 174, 214, 241
C 215, 219, 221

111111111111111111111111111111111111111111111
1202020202020202020202N2020202020202020202021
102020202020202020202020202020202020202020201
120202020202020202020202020202020202020202021
102020202020202020202020202020202020202020201
120202020202020202020202020202020202020202021
102020202020202020202020202020202020202020201
120202020202020202020202020202020202020202021
102020202020202020202020202020202020202020201
120202020202020202020202020202020202020202021
102020202020202020202020202020202020202020201
120202020202020202020202020202020202020202021
102020202020202020202020202020202020202020201
120202020202020202020202020202020202020202021
102020202020202020202020202020202020202020201
120202020202020202020202020202020202020202021
102020202020202020202020202020202020202020201
120202020202020202020202020202020202020202021
102020202020202020202020202020202020202020201
120202020202020202020202020202020202020202021
102020202020202020202020202020202020202020201
120202020202020202020202020202020202020202021
102020202020202020202020202020202020202020201
120202020202020202020202020202020202020202021
102020202020202020202020202020202020202020201
120202020202020202020202020202020202020202021
102020202020202020202020202020202020202020201
120202020202020202020202020202020202020202021
102020202020202020202020202020202020202020201
111111111111111111111111111111111111111111111